Cow	Easy
Pig	Easy
Jubulant	Medium
Row	Easy
Extravagent	Difficult
Ha	Easy
Hi	Easy
YipYip	Medium
Hippo	Easy
Catastrophic	Difficult
Sweden	Medium
Master	Easy
absolutistically	Difficult
bonehead	Medium
actinoelectricity	Difficult
GeneralKenobi	Difficult
Yoda	Easy
Club	Easy
Hog	Easy
Haribo	Medium
Steve	Easy
Yep	Easy